********************
*   NCU_Map.html   *
********************
NCU map 的版面

********************
*      map.js      *
********************
有關地圖的js code

********************
*   listview.js    *
********************
有關search listview 的 js code

********************
*    NCU_Map.css   *
********************
有關地圖外觀的css code 